+---+---+---+---+---+---+---+---+---+---+---+---+---+---+---+---+---+---+---+---+---+
                    |                   |       |                           |       |
+   +   +---+---+   +   +   +---+---+---+   +   +   +---+---+---+---+---+   +---+   +
|   |           |   |   |                   |           |               |       |   |
+   +---+---+   +---+   +---+---+---+---+---+---+---+---+   +---+---+   +---+   +   +
|           |   |       |               |                   |       |           |   |
+   +---+---+   +   +---+   +---+---+   +   +---+---+---+---+---+   +---+---+---+   +
|   |           |           |           |           |           |       |           |
+   +   +---+---+---+---+---+   +---+---+---+---+   +   +   +   +   +   +   +   +---+
|   |   |               |       |       |           |   |   |       |   |   |       |
+   +   +   +---+---+   +   +---+---+   +   +---+---+   +   +---+---+---+   +---+   +
|   |   |       |   |       |           | * |           |           |       |   |   |
+   +   +---+   +   +---+---+   +---+   +---+   +---+---+---+---+   +   +---+   +   +
|   |       |               |   |   |       |       |           |   |   |       |   |
+---+   +---+---+---+---+   +   +   +---+   +---+   +   +---+   +   +   +   +---+   +
|       |               |       |   |       |   |       |       |           |       |
+   +---+   +   +   +---+---+---+   +   +---+   +   +---+---+---+---+---+---+   +   +
|   |       |   |   |               |   |           |                           |   |
+   +   +---+   +---+   +---+---+   +   +---+---+---+   +---+---+---+---+---+---+   +
|   |   |   |           |           |                   |               |           |
+   +   +   +---+---+---+   +---+---+---+---+---+---+---+   +   +---+---+   +---+---+
|                       |                                   |                        
+---+---+---+---+---+---+---+---+---+---+---+---+---+---+---+---+---+---+---+---+---+
